L L L L L L L L L L L L L L L L
L G G G G G G G G G G W G G G L
L G G G G G G G G G W W G G G L
L G G G G G G G G W W W W W G L
L G G G G G G G G G G W W G G L
L G G G G G G G G G G W W G G L
L G G G G G G G G G G G G G G L
L G G G G G G G G G G G G G G L
L G G G G G G G G G G G G G G L
L G G G G G G G G G G G G G G L
L G G G G G G G G G G G G G G L
L L L L L L L L L L L L L L L L